R 1080 720
NO ./textures/redbrick.xpm
SO ./textures/wood.xpm
WE ./textures/purplestone.xpm
EA ./textures/mossy.xpm
S ./textures/barrel.xpm
F 184,113,39
C 51,133,22

111111
100001
100N01
100001
111111
