R 1080 720
NO ./textures/redbrick.xpm
SO ./textures/wood.xpm
WE ./textures/purplestone.xpm
EA ./textures/mossy.xpm
S ./textures/barrel.xpm
F 184,113,39
C 51,133,22

111111111111111111111111
100000000011000000000001
1011000001110000010S0001
100100000000000000000001
111111111011000001110001
100000000011000001110111
100000000000000011010101
110000011101010111110111
111111111111111111111111
